NO textures/wall_1.xpm
SO textures/wall_2.xpm
WE textures/wall_3.xpm
EA textures/wall.xpm

F 18,113,39
C 51,192,227


         11111111  111111111111111111
         111111111  100000000000000001
        1111111111110110000111100000001111111111
11111111110000000000000001111111111111
1111111111050000S000000000111
10000000000000000000000111111
10000000111100010000000001001
1000000010100110101110000001
10000000111110000001 10100001
11111111111111111111 11111111
     
1111 111111111111111111111111
1111 100000000000000000000001
1111 111111111111111111111111
